..S......T
#T....###.
#..SSE...E
#.E...###.
###T#####G