..S......T
#TS...###.
#..SSE...E
#.E...###.
###T#####G