..##..S..T..##..S..T
#T..S.###...##.....#
#.##..###...T.##..#E
#.###E###E#..##T.S##
#.ET..###S#..##..E#.
###T#####.E#....#..G