..##..S..T..##..S..T..#
#T..S.###...##.....##..
#.##..###...T.##..#E...
#.###E###E#..##T.S#####
#.ET..###S#..##..E#.#..
###T#####.E#....#......
..##..S..T..##..S..T..#
#T..S.###...##.....#.##
#.##..###...T.##..#E..#
#.###E###E#..##T.S###..
#.E...###S#..##..E#.#..
###TS####.E#....#.....G